15:15
0,0,0,0,0,0,0,0,0,0,0,0,0,0,0
0,0,0,0,0,0,0,0,0,0,0,0,0,0,0
0,0,0,0,0,0,0,0,c,c,0,0,0,0,0
0,0,0,0,0,0,0,0,c,c,0,0,0,g,0
0,0,0,0,0,0,c,c,0,0,0,0,0,g,0
0,0,0,0,c,c,c,0,0,0,0,0,g,g,0
0,0,0,c,c,0,0,0,0,0,0,g,g,0,0
0,0,c,c,0,0,0,0,g,g,g,g,0,0,0
0,c,c,0,0,0,g,g,g,0,0,0,0,t,t
0,c,0,0,g,g,g,0,0,0,t,t,t,t,0
0,0,0,g,g,0,0,0,t,t,t,0,0,0,0
0,0,g,g,0,0,0,0,t,0,0,0,0,0,0
0,0,0,0,0,0,0,0,0,0,0,0,0,0,0
0,0,0,0,0,0,0,0,0,0,0,0,0,0,0
0,0,0,0,0,0,0,0,0,0,0,0,0,0,0
