8:15
c,0,0,0,0,0,0,0,0,0,0,0,0,0,0
g,g,0,0,0,0,0,0,s,0,0,0,0,0,0
0,0,c,0,0,0,0,0,g,g,g,0,0,e,0
0,0,g,g,0,0,0,0,0,0,0,0,0,g,0
0,0,0,0,0,0,0,0,0,c,0,0,g,g,g
0,0,0,0,0,g,g,e,c,g,0,0,0,0,g
t,0,0,0,g,g,g,g,g,g,g,0,e,c,g
g,g,g,g,g,g,g,g,g,g,g,g,g,g,g
