5:5
0,0,0,0,0
0,0,0,0,0
0,0,0,0,0
0,0,0,e,e
0,e,e,e,e
