5:5
0,0,0,0,0
0,0,0,0,0
0,0,g,g,g
g,g,g,g,g
g,g,g,g,g
