15:15
0,0,0,0,0,0,0,0,0,0,0,0,0,0,0
0,0,c,c,c,c,c,0,0,0,0,0,0,0,0
0,0,1,1,1,1,1,0,0,0,0,0,0,0,0
0,0,0,0,0,0,0,0,0,0,c,0,c,0,s
e,c,c,e,0,0,0,0,0,0,1,1,1,1,1
1,1,1,1,0,0,0,0,0,0,0,0,0,0,0
0,0,0,0,0,c,e,0,0,0,0,0,0,0,0
0,0,0,0,0,1,1,1,0,0,0,0,0,0,0
0,0,0,0,0,0,0,0,0,0,0,0,c,0,0
0,0,0,0,0,0,0,0,0,0,1,1,1,1,0
0,0,0,0,0,0,0,c,0,0,0,0,0,0,0
0,t,0,0,0,0,1,1,1,0,0,0,0,0,0
0,1,1,1,0,0,0,0,0,0,0,0,0,0,0
0,0,0,0,0,0,0,0,0,0,0,0,0,0,0
2,2,2,2,2,2,2,2,2,2,2,2,2,2,2
