15:15
0,0,0,0,0,0,0,0,0,0,0,0,0,0,0
0,0,0,0,0,0,0,0,0,0,0,0,0,0,0
0,0,0,0,0,0,0,0,c,0,0,0,0,0,0
0,0,0,0,0,0,g,g,g,0,0,0,c,0,0
0,0,0,0,0,0,0,0,0,0,0,g,g,g,0
0,0,0,0,g,0,0,e,0,c,0,0,0,0,0
0,0,0,g,0,0,0,g,g,g,0,0,0,0,0
c,0,g,0,0,0,0,0,0,0,0,0,0,0,s
g,0,0,0,0,0,0,0,0,0,0,0,g,g,g
0,g,0,0,0,0,0,0,0,0,0,0,0,0,0
0,0,g,0,0,e,c,0,0,0,c,0,0,0,0
0,0,0,0,g,g,g,0,g,g,g,0,0,0,0
0,0,0,0,0,0,0,0,0,0,0,0,0,0,0
t,0,g,0,0,0,0,c,0,0,e,0,0,g,c
g,g,g,g,g,w,w,g,w,g,g,g,g,g,g
