15:15
000000000000000
000000000000000
000000000000000
000000000000000
000000000000000
000000000000000
000000000000000
001000000000000
001100000000000
000101110000000
000111011111000
000001110001100
000000011000000
000000000000000
222222222222222
Coin(9,14)(10,14)
Enemy(6,14)
Player(2,14)(4,14)
