15:15
0,0,0,0,0,0,0,0,0,0,0,0,0,0,0
0,0,0,0,0,0,0,s,0,0,0,0,0,0,0
0,c,e,0,0,1,1,1,0,0,0,0,0,0,0
0,1,1,1,0,0,0,0,0,0,0,0,0,0,0
0,0,0,0,c,e,c,0,0,0,0,0,0,0,0
0,0,0,0,1,1,1,1,0,0,0,0,0,0,0
0,0,0,0,0,0,0,0,0,0,e,0,c,c,0
c,0,0,0,0,0,0,0,0,1,1,0,1,1,0
1,1,0,0,0,0,0,c,0,0,0,0,0,0,0
0,e,c,0,0,0,0,1,1,0,0,0,0,0,0
0,1,1,1,1,0,0,0,0,e,0,c,0,0,0
0,0,0,0,0,0,0,c,0,1,1,1,0,0,0
t,0,0,0,0,0,1,1,0,0,0,0,0,0,c
1,1,1,1,0,0,0,0,0,0,0,0,0,1,1
2,2,2,2,2,2,2,2,2,2,2,2,2,2,2
